                            
                            
                       N    
 XX    XXX            XX    
 XX P         N             
 XXXX         XX         XX 
 XXXX      NXX              
 XX    X  XXXX    XX  XX    
       X  XXXX    XX  XXX   
    XXXX  XXXXXX  XX  XXXX  
XXXXXXXX  XXXXXX  XX  XXXX  
